0 5 2 0 0 0 5 1 8 1 0 1 4 0 0 
0 0 0 0 0 0 0 5 0 0 6 1 6 0 0 
0 1 0 1 0 0 0 0 0 0 0 0 7 0 0 
0 0 4 0 0 0 5 0 0 1 1 0 0 4 0 
1 0 3 0 0 0 1 0 0 7 0 1 0 4 1 
2 0 0 0 0 3 0 0 1 0 0 7 6 0 0 
3 0 0 1 5 0 0 0 0 0 5 1 0 4 0 
0 0 1 0 4 0 0 0 1 1 0 0 7 0 1 
0 0 8 0 2 0 0 0 0 0 0 6 0 7 3 
