3 3 3 3 3 3 3 3 3 3 3 3 3 3 3
3 0 0 6 0 0 0 0 0 0 0 0 0 0 3
3 7 5 4 0 4 4 4 4 4 0 4 5 4 3
3 0 0 6 0 4 3 2 3 4 2 0 0 0 3
3 0 0 5 0 0 1 1 2 4 2 0 0 0 3
3 0 0 6 0 4 3 2 3 4 2 0 0 0 3
3 0 0 7 0 4 4 4 4 4 4 5 3 3 3
3 0 0 4 0 0 0 0 0 0 0 0 0 0 3
3 3 3 3 3 3 3 3 3 3 3 3 3 3 3