0 0 1 0 0 0 0 0 6 4 4 0 0 0 0
7 6 5 1 1 2 0 0 0 5 0 0 0 0 0
0 0 3 2 1 0 0 0 1 1 0 0 4 0 0
0 0 3 2 1 0 0 1 1 1 0 4 4 4 0
0 0 3 1 1 0 0 0 0 0 0 0 4 4 4
0 0 4 0 0 4 6 0 0 0 0 0 4 0 0
0 0 0 0 0 5 6 0 0 4 3 0 0 0 0
4 4 4 0 0 5 5 0 0 0 3 4 0 0 7
4 4 4 0 0 4 7 0 0 0 3 4 0 0 6