7 8 0 4 1 2 0 0 0 0 0 0 6 5 1 
0 3 0 1 8 5 2 0 6 4 8 0 4 0 3 
0 0 0 0 4 4 8 4 0 0 0 6 0 8 0 
0 1 1 0 0 0 0 0 0 0 0 0 0 0 0 
0 1 0 0 0 0 0 0 0 0 0 3 1 1 5 
1 1 0 0 5 4 7 5 1 0 0 0 0 0 0 
0 1 0 0 3 7 0 2 0 0 0 8 0 0 2 
0 6 0 0 0 4 0 4 1 0 3 0 5 0 0 
1 0 0 1 3 0 4 0 6 1 0 0 0 0 0 
