0 0 3 0 0 0 0 0 8 6 0 0 0 1 1
0 0 3 0 0 0 0 0 4 5 0 0 1 1 1
0 0 3 1 0 0 0 4 6 4 0 0 1 2 2
2 0 2 1 0 0 0 4 4 4 0 1 1 2 2
2 0 2 0 0 0 0 0 0 0 0 1 2 2 2
0 0 0 0 0 1 0 0 5 0 0 1 2 2 2
0 0 0 0 0 0 4 4 3 0 0 1 1 1 1
0 0 0 0 0 5 4 3 3 0 0 0 1 1 1
0 0 0 0 0 7 5 3 3 0 0 0 0 0 1