0 0 8 0 0 0 0 0 0 3 0 6 0 0 0 
1 4 0 2 4 0 1 0 0 0 2 1 0 0 0 
3 0 5 1 1 0 6 4 0 0 1 4 0 0 0 
3 4 0 1 1 0 0 0 1 0 8 2 2 0 2 
3 6 0 0 0 0 0 1 1 1 6 4 3 1 1 
0 0 0 0 0 0 7 1 0 0 0 0 2 0 1 
7 2 6 0 4 8 0 1 6 1 4 0 0 7 6 
8 0 0 0 1 5 1 0 0 4 2 0 1 0 3 
8 0 1 2 1 1 0 1 1 0 0 5 0 1 0 
