3 0 1 0 0 0 1 0 1 0 0 0 7 4 0 
0 0 0 0 1 0 1 4 4 8 0 1 0 0 1 
0 1 0 0 5 0 0 4 6 0 0 0 6 0 0 
0 6 0 0 1 0 4 2 0 5 1 1 0 0 0 
0 1 1 0 0 0 6 6 0 4 0 0 0 0 4 
1 4 1 0 0 7 0 0 3 6 3 0 0 4 1 
2 3 0 0 4 0 0 1 0 0 1 0 6 0 0 
0 0 6 0 0 0 0 4 8 7 0 3 0 0 0 
8 0 0 1 1 5 1 0 1 0 0 0 0 5 8 
