0 0 0 0 0 0 1 2 0 6 0 6 4 7 0 
0 0 0 0 0 0 1 7 1 5 4 0 0 1 0 
0 4 0 0 3 1 2 8 0 0 0 0 0 0 0 
0 0 0 0 0 6 0 0 0 4 0 0 0 5 0 
0 1 0 0 0 7 0 0 0 7 5 6 1 0 0 
4 0 0 6 2 0 1 3 0 4 1 0 4 4 4 
3 7 0 0 7 3 6 0 0 0 0 4 0 0 1 
0 1 5 6 1 0 5 1 1 0 0 0 4 0 0 
1 0 7 0 3 6 1 0 0 7 1 1 3 0 0 
