3 4 0 0 6 2 0 1 0 0 0 0 6 0 4 
0 1 0 3 0 0 0 0 1 8 0 1 0 1 6 
0 6 0 3 4 0 0 3 0 7 7 0 1 0 0 
0 0 0 0 0 1 5 0 4 4 0 0 0 0 1 
2 5 0 2 7 0 0 3 0 0 6 5 1 0 0 
2 0 1 8 0 0 1 0 1 0 1 0 0 0 0 
0 4 3 8 0 2 4 1 0 0 0 0 0 0 0 
8 0 7 0 0 0 0 0 0 8 0 0 4 2 0 
0 3 0 0 1 3 6 0 6 0 0 5 4 0 1 
